S013000068656C6C6F5F776F726C642E7372656376
S315802000003C1C0001279C84000399E02127BDFFD05A
S31580200010AFBF002CAFB40028AFB30024AFB200200E
S31580200020AFB1001CAFB00018AFBC0010000080211B
S315802000308F9980340080902100A020210320F80908
S3158020004000A08821240500068FBC00108F8480188C
S315802000508F9980440320F809248403608FBC001084
S315802000608F99802C0320F809000000008FBC001097
S31580200070004028218F8480188F9980440320F80996
S31580200080248403808FBC00108F8480188F998044AD
S315802000900320F809248403A0024028218FBC001065
S315802000A08F8480188F9980440320F809248403B094
S315802000B08FBC00108F9480188F938018269403BC51
S315802000C010000008267303C48E2600002631000403
S315802000D002602021261000010320F8090286300ABA
S315802000E08FBC00100250102A8F9980441040FFF652
S315802000F0020028218F8480180320F809248403D8BD
S315802001008FBC00108F99803C0320F80900000000E6
S315802001108FBC00101040FFFB000000008F998040AC
S315802001200320F809000000008FBC00108F848018FF
S315802001308F9980440320F809248403F40000102139
S315802001408FBF002C8FB400288FB300248FB200205D
S315802001508FB1001C8FB0001803E0000827BD003047
S315802001608F5900208F3900000320000800000000EE
S315802001708F5900208F3900040320000800000000DA
S315802001808F5900208F3900080320000800000000C6
S315802001908F5900208F39000C0320000800000000B2
S315802001A08F5900208F39001003200008000000009E
S315802001B08F5900208F39001403200008000000008A
S315802001C08F5900208F390018032000080000000076
S315802001D08F5900208F39001C032000080000000062
S315802001E08F5900208F39002003200008000000004E
S315802001F08F5900208F39002403200008000000003A
S315802002008F5900208F390028032000080000000025
S315802002108F5900208F39002C032000080000000011
S315802002208F5900208F3900300320000800000000FD
S315802002308F5900208F3900340320000800000000E9
S315802002408F5900208F3900380320000800000000D5
S315802002508F5900208F39003C0320000800000000C1
S315802002608F5900208F3900400320000800000000AD
S315802002708F5900208F390044032000080000000099
S315802002808F5900208F390048032000080000000085
S315802002908F5900208F39004C032000080000000071
S315802002A08F5900208F39005003200008000000005D
S315802002B08F5900208F390054032000080000000049
S315802002C08F5900208F390058032000080000000035
S315802002D08F5900208F39005C032000080000000021
S315802002E08F5900208F39006003200008000000000D
S315802002F08F5900208F3900640320000800000000F9
S315802003008F5900208F3900680320000800000000E4
S315802003108F5900208F39006C0320000800000000D0
S3158020032003E00008000000003C1C0001279C80D8C8
S315802003300399E0218F8280388F83803010000004DB
S315802003400043202BA0400000244200010043202BA4
S315802003501480FFFC0000000003E00008000000007D
S315802003604578616D706C65206578706563747320DF
S315802003704142492076657273696F6E2025640A0032
S3158020038041637475616C20552D426F6F7420414294
S31580200390492076657273696F6E2025640A00000095
S315802003A048656C6C6F20576F726C640A0000000081
S315802003B061726763203D2025640A00003C4E554CBF
S315802003C04C3E0000617267765B25645D203D20226D
S315802003D02573220A0000000048697420616E792006
S315802003E06B657920746F2065786974202E2E2E2077
S30D802003F0000000000A0A00004B
S315802003F8B21F00740000000000000000000000000A
S30D80200408000000008020840022
S315802004100000000080000000802000000000000016
S315802004200000000000000000000000008020016025
S315802004308020044880200328802004488020018052
S30D8020044080200170802001B0AC
S705802000005A
